{
	"maps": {
		"citymap": {
			"layers": {
				"BASE": [
				[89, 90, 90, 90, 90, 90, 90, 90, 90, 90, 91, 461, 441, 463, 89, 90, 90, 90, 90, 90, 90, 90, 90, 90, 91],
				[116, 117, 117, 117, 117, 117, 117, 117, 117, 117, 118, 461, 441, 463, 116, 117, 117, 117, 117, 117, 117, 117, 117, 117, 118],
				[116, 117, 117, 117, 117, 117, 117, 117, 117, 117, 118, 461, 441, 463, 116, 117, 117, 117, 117, 117, 117, 117, 117, 117, 118],
				[116, 117, 117, 117, 117, 117, 117, 117, 117, 117, 118, 461, 441, 463, 116, 117, 117, 117, 117, 117, 117, 117, 117, 117, 118],
				[116, 117, 117, 117, 117, 117, 117, 117, 117, 117, 118, 461, 441, 463, 116, 117, 117, 117, 117, 117, 117, 117, 117, 117, 118],
				[116, 117, 117, 117, 117, 117, 117, 117, 117, 117, 118, 461, 441, 463, 116, 117, 117, 117, 117, 117, 117, 117, 117, 117, 118],
				[116, 117, 117, 117, 117, 117, 117, 117, 117, 117, 118, 461, 441, 463, 116, 117, 117, 117, 117, 117, 117, 117, 117, 117, 118],
				[116, 117, 117, 117, 117, 117, 117, 117, 117, 117, 118, 461, 441, 463, 116, 117, 117, 117, 117, 117, 117, 117, 117, 117, 118],
				[116, 117, 117, 117, 117, 117, 117, 117, 117, 117, 118, 461, 441, 463, 116, 117, 117, 117, 117, 117, 117, 117, 117, 117, 118],
				[116, 117, 117, 117, 117, 117, 117, 117, 117, 117, 118, 461, 441, 463, 116, 117, 117, 117, 117, 117, 117, 117, 117, 117, 118],
				[116, 117, 117, 117, 117, 117, 117, 117, 117, 117, 118, 461, 441, 463, 116, 117, 117, 117, 117, 117, 117, 117, 117, 117, 118],
				[116, 117, 117, 117, 117, 117, 117, 117, 117, 117, 118, 461, 441, 463, 116, 117, 117, 117, 117, 117, 117, 117, 117, 117, 118],
				[116, 117, 117, 117, 117, 117, 117, 117, 117, 117, 118, 461, 441, 463, 116, 117, 117, 117, 117, 117, 117, 117, 117, 117, 118],
				[116, 117, 117, 117, 117, 117, 117, 117, 117, 117, 118, 461, 441, 463, 116, 117, 117, 117, 117, 117, 117, 117, 117, 117, 118],
				[116, 117, 117, 117, 117, 117, 117, 117, 117, 117, 118, 461, 441, 463, 116, 117, 117, 117, 117, 117, 117, 117, 117, 117, 118],
				[143, 144, 144, 144, 144, 144, 144, 144, 144, 144, 145, 461, 441, 463, 143, 144, 144, 144, 144, 144, 144, 144, 144, 144, 145],
				[406, 406, 406, 406, 406, 406, 406, 406, 406, 406, 406, 467, 441, 466, 406, 406, 406, 406, 406, 406, 406, 406, 406, 406, 406],
				[441, 441, 441, 441, 441, 441, 441, 441, 441, 441, 441, 441, 441, 441, 441, 441, 441, 441, 441, 441, 441, 441, 441, 441, 441],
				[460, 460, 460, 460, 460, 460, 460, 460, 460, 460, 460, 440, 441, 439, 460, 460, 460, 460, 460, 460, 460, 460, 460, 460, 460],
				[89, 90, 90, 90, 90, 90, 90, 90, 90, 90, 91, 461, 441, 463, 89, 90, 90, 90, 90, 90, 90, 90, 90, 90, 91],
				[116, 117, 117, 117, 117, 117, 117, 117, 117, 117, 118, 461, 441, 463, 116, 117, 117, 117, 117, 117, 117, 117, 117, 117, 118],
				[116, 117, 117, 117, 117, 117, 117, 117, 117, 117, 118, 461, 441, 463, 116, 117, 117, 117, 117, 117, 117, 117, 117, 117, 118],
				[116, 117, 117, 117, 117, 117, 117, 117, 117, 117, 118, 461, 441, 463, 116, 117, 117, 117, 117, 117, 117, 117, 117, 117, 118],
				[116, 117, 117, 117, 117, 117, 117, 117, 117, 117, 118, 461, 441, 463, 116, 117, 117, 117, 117, 117, 117, 117, 117, 117, 118],
				[143, 144, 144, 144, 144, 144, 144, 144, 144, 144, 145, 461, 441, 463, 143, 144, 144, 144, 144, 144, 144, 144, 144, 144, 145]
			],
			"OVERLAY": [
				[486, 486, 486, 486, 486, 486, 486, 486, 486, 486, 486, 486, 486, 486, 0, 1, 1, 1, 1, 1, 1, 58, 58, 58, 4 ],
				[486, 486, 486, 486, 486, 486, 486, 486, 486, 486, 486, 486, 486, 486, 27, 28, 28, 28, 28, 28, 29, 28, 28, 28, 34 ],
				[486, 486, 486, 486, 486, 486, 486, 486, 486, 486, 486, 486, 486, 486, 27, 28, 28, 28, 28, 28, 29, 28, 28, 28, 34 ],
				[486, 486, 486, 486, 486, 486, 486, 486, 486, 486, 486, 486, 486, 486, 27, 28, 28, 28, 28, 28, 29, 28, 28, 28, 34 ],
				[486, 486, 486, 486, 486, 486, 486, 486, 486, 486, 486, 486, 486, 486, 27, 28, 28, 28, 28, 28, 32, 1, 1, 1, 29 ],
				[486, 486, 486, 486, 486, 486, 486, 486, 486, 486, 486, 486, 486, 486, 27, 28, 28, 28, 28, 28, 28, 28, 28, 28, 29 ],
				[486, 486, 486, 486, 486, 486, 486, 486, 486, 486, 486, 486, 486, 486, 27, 28, 28, 28, 28, 28, 28, 28, 28, 28, 29 ],
				[486, 486, 486, 486, 486, 486, 486, 486, 486, 486, 486, 486, 486, 486, 27, 28, 28, 28, 28, 28, 28, 28, 28, 28, 29 ],
				[486, 486, 486, 486, 486, 486, 486, 486, 486, 486, 486, 486, 486, 486, 54, 55, 55, 55, 55, 55, 55, 55, 55, 55, 56],
				[486, 486, 486, 486, 486, 486, 486, 486, 486, 486, 486, 486, 486, 486, 89, 90, 90, 90, 90, 90, 90, 90, 90, 90, 91 ],
				[486, 486, 486, 486, 486, 486, 486, 486, 486, 486, 486, 486, 486, 486, 486, 486, 486, 486, 486, 486, 486, 486, 486, 486, 486],
				[486, 486, 486, 486, 486, 486, 486, 486, 486, 486, 486, 486, 486, 486, 486, 486, 486, 486, 486, 486, 486, 486, 486, 486, 486],
				[486, 486, 486, 486, 486, 486, 486, 486, 486, 486, 486, 486, 486, 486, 486, 486, 486, 486, 486, 486, 486, 486, 486, 486, 486],
				[486, 486, 486, 486, 486, 486, 486, 486, 486, 486, 486, 486, 486, 486, 486, 486, 486, 486, 486, 486, 486, 486, 486, 486, 486],
				[486, 486, 486, 486, 486, 486, 486, 486, 486, 486, 486, 486, 486, 486, 486, 486, 486, 486, 486, 486, 486, 486, 486, 486, 486],
				[486, 486, 486, 486, 486, 486, 486, 486, 486, 486, 486, 486, 486, 486, 486, 486, 486, 486, 486, 486, 486, 486, 486, 486, 486],
				[486, 486, 486, 486, 486, 486, 486, 486, 486, 486, 486, 486, 486, 486, 486, 486, 486, 486, 486, 486, 486, 486, 486, 486, 486],
				[486, 486, 486, 486, 486, 486, 486, 486, 486, 486, 486, 486, 486, 486, 486, 486, 486, 486, 486, 486, 486, 486, 486, 486, 486],
				[486, 486, 486, 486, 486, 486, 486, 486, 486, 486, 486, 486, 486, 486, 486, 486, 486, 486, 486, 486, 486, 486, 486, 486, 486],
				[486, 486, 486, 486, 486, 486, 486, 486, 486, 486, 486, 486, 486, 486, 486, 486, 486, 486, 486, 486, 486, 486, 486, 486, 486],
				[486, 486, 486, 486, 486, 486, 486, 486, 486, 486, 486, 486, 486, 486, 486, 486, 486, 486, 486, 486, 486, 486, 486, 486, 486],
				[486, 486, 486, 486, 486, 486, 486, 486, 486, 486, 486, 486, 486, 486, 486, 486, 486, 486, 486, 486, 486, 486, 486, 486, 486],
				[486, 486, 486, 486, 486, 486, 486, 486, 486, 486, 486, 486, 486, 486, 486, 486, 486, 486, 486, 486, 486, 486, 486, 486, 486],
				[486, 486, 486, 486, 486, 486, 486, 486, 486, 486, 486, 486, 486, 486, 486, 486, 486, 486, 486, 486, 486, 486, 486, 486, 486],
				[486, 486, 486, 486, 486, 486, 486, 486, 486, 486, 486, 486, 486, 486, 486, 486, 486, 486, 486, 486, 486, 486, 486, 486, 486]
			],
			"COLLIDE": [
				[486, 486, 486, 486, 486, 486, 486, 486, 486, 486, 486, 486, 486, 486, 486, 486, 486, 486, 486, 486, 486, 486, 486, 486, 486],
				[486, 486, 486, 486, 486, 486, 486, 486, 486, 486, 486, 486, 486, 486, 486, 486, 486, 486, 486, 486, 486, 198, 198, 198, 486],
				[486, 486, 486, 486, 486, 486, 486, 486, 486, 486, 486, 486, 486, 486, 486, 486, 486, 486, 486, 486, 486, 198, 198, 198, 486],
				[486, 486, 486, 486, 486, 486, 486, 486, 486, 486, 486, 486, 486, 486, 486, 486, 486, 486, 486, 486, 486, 198, 198, 198, 486],
				[486, 486, 486, 486, 486, 486, 486, 486, 486, 486, 486, 486, 486, 486, 486, 486, 486, 486, 486, 486, 486, 486, 486, 486, 486],
				[486, 486, 486, 486, 486, 486, 486, 486, 486, 486, 486, 192, 486, 486, 486, 486, 486, 486, 486, 259, 486, 486, 486, 486, 486],
				[486, 486, 486, 486, 486, 486, 486, 486, 486, 486, 486, 486, 486, 486, 486, 486, 486, 486, 486, 486, 486, 486, 486, 486, 486],
				[486, 486, 486, 486, 486, 486, 486, 486, 486, 486, 486, 486, 486, 486, 486, 486, 486, 486, 486, 486, 486, 486, 486, 486, 486],
				[486, 486, 486, 486, 486, 486, 486, 486, 486, 486, 486, 486, 486, 486, 486, 486, 486, 486, 486, 486, 486, 486, 486, 486, 486],
				[486, 486, 486, 486, 486, 486, 486, 486, 486, 486, 486, 486, 486, 486, 486, 486, 486, 486, 486, 486, 486, 486, 486, 486, 486],
				[486, 486, 486, 486, 486, 486, 486, 486, 486, 486, 486, 486, 486, 486, 486, 486, 486, 486, 486, 486, 486, 486, 486, 486, 486],
				[486, 486, 486, 486, 486, 486, 486, 486, 486, 486, 486, 486, 486, 486, 486, 486, 486, 486, 486, 486, 486, 486, 486, 486, 486],
				[486, 486, 486, 486, 486, 486, 486, 486, 486, 486, 486, 192, 486, 422, 486, 486, 486, 486, 486, 486, 486, 486, 486, 486, 486],
				[486, 486, 486, 486, 486, 486, 486, 486, 486, 486, 486, 486, 486, 486, 486, 486, 486, 486, 486, 486, 486, 486, 486, 486, 486],
				[486, 486, 486, 486, 486, 486, 486, 486, 486, 486, 486, 486, 486, 486, 486, 486, 486, 486, 486, 486, 486, 486, 486, 486, 486],
				[486, 486, 486, 486, 486, 486, 486, 486, 486, 486, 486, 486, 486, 486, 486, 486, 486, 486, 486, 486, 486, 486, 486, 486, 486],
				[486, 486, 486, 486, 486, 486, 486, 486, 486, 486, 486, 486, 486, 486, 486, 486, 486, 486, 486, 486, 486, 486, 486, 486, 486],
				[486, 486, 486, 486, 486, 486, 486, 486, 486, 486, 486, 486, 486, 486, 486, 486, 486, 486, 486, 486, 486, 486, 486, 486, 486],
				[486, 486, 486, 486, 486, 486, 486, 486, 486, 486, 486, 486, 486, 486, 486, 486, 486, 486, 486, 486, 486, 486, 486, 486, 486],
				[486, 486, 486, 486, 486, 486, 486, 486, 486, 486, 486, 192, 486, 486, 486, 486, 486, 486, 486, 486, 486, 486, 486, 486, 486],
				[486, 486, 486, 486, 486, 486, 486, 486, 486, 486, 486, 486, 486, 486, 486, 486, 486, 486, 486, 486, 486, 486, 486, 486, 486],
				[486, 486, 486, 486, 486, 486, 486, 486, 486, 486, 486, 486, 486, 486, 486, 486, 486, 486, 486, 486, 486, 486, 486, 486, 486],
				[486, 486, 486, 486, 486, 486, 486, 486, 486, 486, 486, 486, 486, 486, 486, 486, 486, 486, 486, 486, 486, 486, 486, 486, 486],
				[486, 486, 486, 486, 486, 486, 486, 486, 486, 486, 486, 486, 486, 486, 486, 486, 486, 486, 486, 486, 486, 486, 486, 486, 486],
				[486, 486, 486, 486, 486, 486, 486, 486, 486, 486, 486, 486, 486, 486, 486, 486, 486, 486, 486, 486, 486, 486, 486, 486, 486]
			],
			"INTERACT": [
				[486, 486, 486, 486, 486, 486, 486, 486, 486, 486, 486, 486, 486, 486, 486, 486, 486, 486, 486, 486, 486, 486, 486, 486, 486],
				[486, 486, 486, 486, 486, 486, 486, 486, 486, 486, 486, 486, 486, 486, 486, 486, 486, 486, 486, 486, 486, 486, 486, 486, 486],
				[486, 486, 486, 486, 486, 486, 486, 486, 486, 486, 486, 486, 486, 486, 486, 486, 486, 486, 486, 486, 486, 486, 486, 486, 486],
				[486, 486, 486, 486, 486, 486, 486, 486, 486, 486, 486, 486, 486, 486, 486, 486, 486, 486, 486, 486, 486, 486, 486, 486, 486],
				[486, 486, 486, 486, 486, 486, 486, 486, 486, 486, 486, 486, 486, 486, 486, 486, 486, 486, 486, 486, 486, 486, 486, 486, 486],
				[486, 486, 486, 486, 486, 486, 486, 486, 486, 486, 486, 192, 486, 486, 486, 486, 486, 486, 486, 259, 486, 486, 486, 486, 486],
				[486, 486, 486, 486, 486, 486, 486, 486, 486, 486, 486, 486, 486, 486, 486, 486, 486, 486, 486, 486, 486, 486, 486, 486, 486],
				[486, 486, 486, 486, 486, 486, 486, 486, 486, 486, 486, 486, 486, 486, 486, 486, 486, 486, 486, 486, 486, 486, 486, 486, 486],
				[486, 486, 486, 339, 486, 486, 486, 486, 486, 486, 486, 486, 486, 486, 486, 486, 486, 486, 486, 486, 486, 486, 486, 486, 486],
				[486, 486, 486, 486, 486, 486, 486, 486, 486, 486, 486, 486, 486, 486, 486, 486, 486, 486, 486, 486, 486, 486, 486, 486, 486],
				[486, 486, 486, 486, 486, 486, 486, 486, 486, 486, 486, 486, 486, 486, 486, 486, 486, 486, 486, 486, 486, 486, 486, 486, 486],
				[486, 486, 486, 339, 486, 486, 486, 486, 486, 486, 486, 486, 486, 486, 486, 486, 486, 486, 486, 486, 486, 486, 486, 486, 486],
				[486, 486, 486, 486, 486, 486, 486, 486, 486, 486, 486, 486, 486, 486, 486, 486, 486, 486, 486, 486, 486, 486, 486, 486, 486],
				[486, 486, 486, 486, 486, 486, 486, 486, 486, 486, 486, 486, 486, 486, 486, 486, 486, 486, 486, 486, 486, 486, 486, 486, 486],
				[486, 486, 486, 486, 486, 486, 486, 486, 486, 486, 486, 486, 486, 486, 486, 486, 486, 486, 486, 486, 486, 486, 486, 486, 486],
				[486, 486, 486, 486, 486, 486, 486, 486, 486, 486, 486, 486, 486, 486, 486, 486, 486, 486, 486, 486, 486, 486, 486, 486, 486],
				[486, 486, 486, 486, 486, 486, 486, 486, 486, 486, 486, 486, 486, 486, 486, 486, 486, 486, 486, 486, 486, 486, 486, 486, 486],
				[486, 486, 486, 486, 486, 486, 486, 486, 486, 486, 486, 486, 486, 486, 486, 486, 486, 486, 486, 486, 486, 486, 486, 486, 486],
				[486, 486, 486, 486, 486, 486, 486, 486, 486, 486, 486, 486, 486, 486, 486, 486, 486, 486, 486, 486, 486, 486, 486, 486, 486],
				[486, 486, 486, 486, 486, 486, 486, 486, 486, 486, 486, 486, 486, 486, 486, 486, 486, 486, 486, 486, 486, 486, 486, 486, 486],
				[486, 486, 486, 486, 486, 486, 486, 486, 486, 486, 486, 486, 486, 486, 486, 486, 486, 486, 486, 486, 486, 486, 486, 486, 486],
				[486, 486, 486, 486, 486, 486, 486, 486, 486, 486, 486, 486, 486, 486, 486, 486, 486, 486, 486, 486, 486, 486, 486, 486, 486],
				[486, 486, 486, 486, 486, 486, 486, 486, 486, 486, 486, 486, 486, 486, 486, 486, 486, 486, 486, 486, 486, 486, 486, 486, 486],
				[486, 486, 486, 486, 486, 486, 486, 486, 486, 486, 486, 486, 486, 486, 486, 486, 486, 486, 486, 486, 486, 486, 486, 486, 486],
				[486, 486, 486, 486, 486, 486, 486, 486, 486, 486, 486, 486, 486, 486, 486, 486, 486, 486, 486, 486, 486, 486, 486, 486, 486]
			],
			"TOP": [
				[486, 486, 486, 486, 486, 486, 486, 486, 486, 486, 486, 486, 486, 486, 486, 486, 486, 486, 486, 486, 486, 486, 486, 486, 486],
				[486, 486, 486, 486, 486, 486, 486, 486, 486, 486, 486, 486, 486, 486, 486, 486, 486, 486, 486, 486, 486, 486, 486, 486, 486],
				[486, 486, 486, 486, 486, 486, 486, 486, 486, 486, 486, 486, 486, 486, 486, 486, 486, 486, 486, 486, 486, 486, 486, 486, 486],
				[486, 486, 486, 486, 486, 486, 486, 486, 486, 486, 486, 486, 486, 486, 486, 486, 486, 486, 486, 486, 486, 486, 486, 486, 486],
				[486, 486, 486, 486, 486, 486, 486, 486, 486, 486, 486, 165, 486, 486, 486, 486, 486, 486, 486, 232, 486, 486, 486, 486, 486],
				[486, 486, 486, 486, 486, 486, 486, 486, 486, 486, 486, 486, 486, 486, 486, 486, 486, 486, 486, 486, 486, 486, 486, 486, 486],
				[486, 486, 486, 486, 486, 486, 486, 486, 486, 486, 486, 486, 486, 486, 486, 486, 486, 486, 486, 486, 486, 486, 486, 486, 486],
				[486, 486, 486, 486, 486, 486, 486, 486, 486, 486, 486, 486, 486, 486, 486, 486, 486, 486, 486, 486, 486, 486, 486, 486, 486],
				[486, 486, 486, 486, 486, 486, 486, 486, 486, 486, 486, 486, 486, 486, 486, 486, 486, 486, 486, 486, 486, 486, 486, 486, 486],
				[486, 486, 486, 486, 486, 486, 486, 486, 486, 486, 486, 486, 486, 486, 486, 486, 486, 486, 486, 486, 486, 486, 486, 486, 486],
				[486, 486, 486, 486, 486, 486, 486, 486, 486, 486, 486, 486, 486, 486, 486, 486, 486, 486, 486, 486, 486, 486, 486, 486, 486],
				[486, 486, 486, 486, 486, 486, 486, 486, 486, 486, 486, 165, 486, 395, 486, 486, 486, 486, 486, 486, 486, 486, 486, 486, 486],
				[486, 486, 486, 486, 486, 486, 486, 486, 486, 486, 486, 486, 486, 486, 486, 486, 486, 486, 486, 486, 486, 486, 486, 486, 486],
				[486, 486, 486, 486, 486, 486, 486, 486, 486, 486, 486, 486, 486, 486, 486, 486, 486, 486, 486, 486, 486, 486, 486, 486, 486],
				[486, 486, 486, 486, 486, 486, 486, 486, 486, 486, 486, 486, 486, 486, 486, 486, 486, 486, 486, 486, 486, 486, 486, 486, 486],
				[486, 486, 486, 486, 486, 486, 486, 486, 486, 486, 486, 486, 486, 486, 486, 486, 486, 486, 486, 486, 486, 486, 486, 486, 486],
				[486, 486, 486, 486, 486, 486, 486, 486, 486, 486, 486, 486, 486, 486, 486, 486, 486, 486, 486, 486, 486, 486, 486, 486, 486],
				[486, 486, 486, 486, 486, 486, 486, 486, 486, 486, 486, 486, 486, 486, 486, 486, 486, 486, 486, 486, 486, 486, 486, 486, 486],
				[486, 486, 486, 486, 486, 486, 486, 486, 486, 486, 486, 165, 486, 486, 486, 486, 486, 486, 486, 486, 486, 486, 486, 486, 486],
				[486, 486, 486, 486, 486, 486, 486, 486, 486, 486, 486, 486, 486, 486, 486, 486, 486, 486, 486, 486, 486, 486, 486, 486, 486],
				[486, 486, 486, 486, 486, 486, 486, 486, 486, 486, 486, 486, 486, 486, 486, 486, 486, 486, 486, 486, 486, 486, 486, 486, 486],
				[486, 486, 486, 486, 486, 486, 486, 486, 486, 486, 486, 486, 486, 486, 486, 486, 486, 486, 486, 486, 486, 486, 486, 486, 486],
				[486, 486, 486, 486, 486, 486, 486, 486, 486, 486, 486, 486, 486, 486, 486, 486, 486, 486, 486, 486, 486, 486, 486, 486, 486],
				[486, 486, 486, 486, 486, 486, 486, 486, 486, 486, 486, 486, 486, 486, 486, 486, 486, 486, 486, 486, 486, 486, 486, 486, 486],
				[486, 486, 486, 486, 486, 486, 486, 486, 486, 486, 486, 486, 486, 486, 486, 486, 486, 486, 486, 486, 486, 486, 486, 486, 486]
			]
			},
			"portals": ["grass-city"]
		},
		"fieldmap": {
			"layers": {
				"BASE": [
					[8, 1, 1, 1, 1, 1, 1, 1, 1, 1, 1, 1, 1, 1, 1, 8],
					[27, 28, 28, 28, 28, 28, 28, 28, 28, 28, 28, 28, 28, 28, 28, 29],
					[27, 28, 28, 28, 28, 28, 28, 28, 28, 28, 28, 28, 28, 28, 28, 29],
					[27, 28, 28, 28, 28, 28, 28, 28, 28, 28, 28, 28, 28, 28, 28, 29],
					[27, 28, 28, 28, 28, 28, 198, 198, 28, 28, 28, 28, 28, 28, 28, 29],
					[27, 28, 28, 28, 28, 28, 198, 198, 28, 28, 28, 28, 28, 28, 28, 29],
					[27, 28, 28, 28, 28, 28, 28, 28, 28, 28, 28, 28, 28, 28, 28, 29],
					[27, 28, 28, 28, 28, 28, 28, 28, 28, 28, 28, 28, 28, 28, 28, 29],
					[27, 28, 28, 28, 28, 28, 28, 28, 28, 28, 28, 28, 28, 28, 28, 29],
					[27, 28, 28, 28, 28, 28, 28, 28, 28, 28, 28, 28, 28, 28, 28, 29],
					[27, 28, 28, 28, 28, 28, 28, 28, 28, 28, 28, 28, 28, 28, 28, 29],
					[27, 28, 28, 28, 28, 28, 28, 28, 28, 28, 28, 28, 28, 28, 28, 29],
					[8, 55, 55, 55, 55, 55, 55, 55, 55, 55, 55, 55, 55, 55, 55, 8]
				],
				"OVERLAY": [
					[0, 486, 486, 486, 486, 486, 486, 486, 486, 486, 486, 486, 486, 486, 486, 2],
					[486, 486, 486, 486, 486, 486, 486, 486, 486, 486, 486, 486, 486, 486, 486, 486],
					[486, 486, 486, 486, 486, 486, 486, 486, 486, 486, 486, 486, 486, 486, 486, 486],
					[486, 486, 486, 486, 486, 486, 486, 486, 486, 486, 486, 486, 486, 486, 486, 486],
					[486, 486, 486, 486, 486, 486, 486, 486, 486, 486, 486, 486, 486, 486, 486, 486],
					[486, 486, 486, 486, 486, 486, 486, 486, 486, 486, 486, 486, 486, 486, 486, 486],
					[486, 486, 486, 486, 486, 486, 486, 486, 486, 486, 486, 486, 486, 486, 486, 486],
					[486, 486, 486, 486, 486, 486, 486, 486, 486, 486, 486, 486, 486, 486, 486, 486],
					[486, 486, 486, 486, 486, 486, 486, 486, 486, 486, 486, 486, 486, 486, 486, 486],
					[486, 486, 486, 486, 486, 486, 486, 486, 486, 486, 486, 486, 486, 486, 486, 486],
					[486, 486, 486, 486, 486, 486, 486, 486, 486, 486, 486, 486, 486, 486, 486, 486],
					[486, 486, 486, 486, 486, 486, 486, 486, 486, 486, 486, 486, 486, 486, 486, 486],
					[54, 486, 486, 486, 486, 486, 486, 486, 486, 486, 486, 486, 486, 486, 486, 56]
				],
				"COLLIDE": [
					[486, 486, 486, 486, 486, 486, 486, 486, 486, 486, 486, 486, 486, 486, 486, 486],
					[486, 486, 486, 486, 486, 486, 486, 486, 486, 486, 486, 486, 486, 486, 486, 486],
					[486, 486, 486, 486, 486, 486, 486, 486, 486, 486, 486, 486, 486, 486, 486, 486],
					[486, 486, 486, 486, 486, 170, 171, 171, 172, 486, 486, 486, 486, 486, 486, 486],
					[486, 486, 486, 486, 486, 197, 486, 486, 199, 486, 486, 486, 486, 486, 486, 486],
					[486, 486, 486, 486, 486, 197, 486, 486, 199, 486, 486, 486, 486, 486, 486, 486],
					[486, 486, 486, 486, 486, 224, 225, 225, 226, 486, 486, 486, 486, 486, 486, 486],
					[486, 486, 486, 486, 486, 486, 486, 486, 486, 486, 486, 486, 486, 486, 486, 486],
					[486, 486, 486, 486, 486, 486, 486, 486, 486, 486, 486, 486, 486, 486, 486, 486],
					[486, 486, 486, 486, 486, 486, 486, 486, 486, 486, 486, 486, 486, 486, 486, 486],
					[486, 486, 486, 486, 486, 486, 486, 486, 486, 486, 486, 261, 262, 262, 263, 486],
					[486, 486, 486, 486, 486, 486, 486, 486, 486, 486, 486, 288, 289, 289, 290, 486],
					[486, 486, 486, 486, 486, 486, 486, 486, 486, 486, 486, 486, 486, 486, 486, 486]
				],
				"INTERACT": [
					[486, 486, 486, 486, 486, 486, 486, 486, 486, 486, 486, 486, 486, 486, 486, 486],
					[486, 339, 486, 486, 486, 486, 486, 486, 486, 486, 486, 486, 486, 486, 486, 486],
					[486, 486, 486, 486, 486, 486, 486, 486, 486, 486, 486, 486, 486, 486, 486, 486],
					[486, 486, 486, 486, 486, 486, 486, 486, 486, 486, 486, 486, 486, 486, 486, 486],
					[486, 486, 486, 486, 486, 486, 486, 486, 486, 486, 486, 486, 486, 486, 486, 486],
					[486, 486, 486, 486, 486, 486, 486, 486, 486, 486, 486, 486, 486, 486, 486, 486],
					[486, 486, 486, 486, 486, 486, 486, 486, 486, 486, 486, 486, 486, 486, 486, 486],
					[486, 486, 486, 486, 486, 486, 486, 486, 486, 486, 486, 486, 486, 486, 486, 486],
					[486, 486, 486, 486, 486, 486, 486, 486, 486, 486, 486, 486, 486, 486, 486, 486],
					[486, 486, 486, 486, 486, 486, 486, 486, 486, 486, 486, 486, 486, 486, 486, 486],
					[486, 486, 486, 486, 486, 486, 339, 486, 486, 486, 486, 486, 486, 486, 486, 486],
					[486, 486, 486, 486, 486, 486, 486, 486, 486, 486, 486, 486, 486, 486, 486, 486],
					[486, 486, 486, 486, 486, 486, 486, 486, 486, 486, 486, 486, 486, 486, 486, 486]
				],
				"TOP": [
					[486, 486, 486, 486, 486, 486, 486, 486, 486, 486, 486, 486, 486, 486, 486, 486],
					[486, 486, 486, 486, 486, 486, 486, 486, 486, 486, 486, 486, 486, 486, 486, 486],
					[486, 486, 486, 486, 486, 486, 486, 486, 486, 486, 486, 486, 486, 486, 486, 486],
					[486, 486, 486, 486, 486, 486, 486, 486, 486, 486, 486, 486, 486, 486, 486, 486],
					[486, 486, 486, 486, 486, 486, 486, 486, 486, 486, 486, 486, 486, 486, 486, 486],
					[486, 486, 486, 486, 486, 486, 486, 486, 486, 486, 486, 486, 486, 486, 486, 486],
					[486, 486, 486, 486, 486, 486, 486, 486, 486, 486, 486, 486, 486, 486, 486, 486],
					[486, 486, 486, 486, 486, 486, 486, 486, 486, 486, 486, 486, 486, 486, 486, 486],
					[486, 486, 486, 486, 486, 486, 486, 486, 486, 486, 486, 486, 486, 486, 486, 486],
					[486, 486, 486, 486, 486, 486, 486, 486, 486, 486, 486, 234, 235, 235, 236, 486],
					[486, 486, 486, 486, 486, 486, 486, 486, 486, 486, 486, 486, 486, 486, 486, 486],
					[486, 486, 486, 486, 486, 486, 486, 486, 486, 486, 486, 486, 486, 486, 486, 486],
					[486, 486, 486, 486, 486, 486, 486, 486, 486, 486, 486, 486, 486, 486, 486, 486]
				]
			},
			"portals": ["grass-city"]
		},
		"jailmap": {
			"layers": {
						"BASE": [
				[486, 486, 486, 486, 486],
				[486,89, 90, 91, 486],
				[486, 116, 117, 118, 486],
				[486, 143, 144, 145, 486],
				[486, 486, 486, 486, 486]
			],
			"OVERLAY": [
				[486, 486, 486, 486, 486],
				[486,486, 486, 486, 486],
				[486, 486, 486, 486, 486],
				[486, 486, 486, 486, 486],
				[486, 486, 486, 486, 486]
			],
			"COLLIDE": [
				[170, 171, 171, 171, 172],
				[197,486, 486, 486, 199],
				[197, 486, 486, 486, 199],
				[197, 486, 486, 486, 199],
				[224, 486, 486, 486, 226]
			],
			"INTERACT": [
				[486, 486, 486, 486, 486],
				[486,339, 486, 486, 486],
				[486, 486, 486, 486, 486],
				[486, 486, 486, 339, 486],
				[486, 486, 486, 486, 486]
			],
			"TOP": [
				[486, 486, 486, 486, 486],
				[486,486, 486, 486, 486],
				[486, 486, 486, 486, 486],
				[486, 486, 486, 486, 486],
				[486, 486, 486, 486, 486]
			]	
			},
			"portals": []
		}
	},
	"portals": {
		"grass-city": {
			"sprite": "339",
			"locations": [{"location":[20,20],"map":"fieldmap"},{"location":[30,10],"map":"citymap"}]
		}
	}
}